B.P.B.-.-.-.G.G.-.-
-.-.S.-.B.-.-.-.-.-
-.S.W.SB.P.B.-.-.-.-
-.-.S.B.B.-.-.-.-.-
-.-.B.P.B.-.-.G.G.-
-.B.P.B.P.B.-.-.-.-
-.-.B.-.B.-.G.G.-.-
-.-.-.-.-.G.G.-.-.-
-.G.G.-.-.A.-.-.G.G
-.-.-.-.-.-.-.B.P.B
