10
-.-.-.B.P.B.-.-.-.-
-.-.S.B.P.B.-.-.-.-
-.BS.W.BS.P.B.-.-.-.-
B.P.BS.-.B.-.-.-.-.-
P.B.-.-.-.-.-.-.-.-
B.-.-.-.-.-.B.-.-.-
-.-.G.-.-.B.P.B.-.-
-.-.-.-.-.-.B.-.B.-
-.-.-.-.-.-.-.B.P.B
A.-.-.-.-.-.-.G.B.-
