10
B.P.B.-.-.-.-.-.-.-
-.B.S.G.B.-.-.-.-.-
-.S.W.BS.P.B.-.-.-.-
-.-.S.B.B.-.-.-.S.-
-.-.B.P.B.-.-.S.W.S
-.B.P.B.P.B.-.-.S.-
-.-.B.-.B.-.-.-.-.-
-.-.-.-.-.-.-.-.-.-
-.-.-.-.-.-.A.-.B.-
-.-.-.-.-.-.-.B.P.B
