10
-.-.-.G.G.-.-.-.-.-
-.-.-.B.A.G.G.-.-.B
-.-.B.P.B.-.-.-.B.P
-.-.-.B.-.B.-.-.-.B
-.-.B.P.B.P.B.-.-.-
-.-.-.B.-.B.-.-.-.-
-.-.-.-.-.-.B.G.S.-
-.G.-.-.-.B.P.SB.W.S
-.G.-.-.-.-.B.-.S.-
-.-.-.-.-.-.-.-.-.-
