10
-.-.-.-.-.-.-.-.-.-
-.-.-.B.-.-.-.-.-.B
-.-.B.P.B.-.-.-.B.P
-.-.-.B.-.B.-.-.-.B
-.-.B.P.B.P.B.-.-.-
-.-.-.B.-.B.-.-.-.-
-.-.-.-.-.-.B.G.S.-
-.-.-.-.-.B.P.BS.W.S
-.-.-.-.-.-.B.-.S.-
A.-.-.-.-.-.-.-.-.-
