10
B.-.-.-.-.-.-.G.-.-
P.B.-.-.-.-.-.-.-.-
B.-.-.-.-.-.-.-.B.-
-.-.-.S.-.-.-.B.P.B
-.-.BS.W.S.-.-.-.B.-
-.B.P.BS.-.-.-.-.-.-
-.B.P.B.B.-.-.-.-.-
-.-.B.B.P.B.-.-.B.-
-.-.-.B.B.-.-.B.P.B
A.-.B.P.B.-.-.-.B.-
