10
-.-.-.B.P.B.-.-.-.-
-.-.S.B.P.B.-.-.-.-
-.SB.W.SB.P.B.-.-.-.-
B.P.SB.-.B.-.-.-.-.-
P.B.-.-.-.-.-.-.-.-
B.-.-.-.-.-.B.-.-.-
-.-.G.-.-.B.P.B.-.-
-.-.-.-.-.-.B.-.B.-
-.-.-.-.-.-.-.B.P.B
A.-.-.-.-.-.-.G.B.-
