10
B.P.B.-.-.-.-.-.-.-
-.B.S.G.B.-.-.-.-.-
-.S.W.SB.P.B.-.-.-.-
-.-.S.B.B.-.-.-.S.-
-.-.B.P.B.-.-.S.W.S
-.B.P.B.P.B.-.-.S.-
-.-.B.-.B.-.-.-.-.-
-.-.-.-.-.-.-.-.-.-
-.-.G.-.-.-.A.-.B.G
-.-.-.-.-.-.-.B.P.B
