10
-.-.-.B.P.B.-.-.-.-
-.-.S.B.P.B.-.-.G.-
-.SB.W.SB.P.B.-.-.-.-
B.P.SB.-.B.-.-.-.-.-
P.B.-.-.-.-.-.-.-.-
B.-.-.-.-.-.B.-.-.-
-.-.-.-.-.B.P.B.-.-
-.-.-.-.-.-.B.-.B.-
-.-.G.-.G.-.-.B.P.B
A.-.-.-.-.-.-.-.B.-
