-.-.-.-.S.-.-.-.-.-
-.-.-.S.W.S.-.-.-.-
-.-.-.-.SB.G.B.-.-.-
G.-.-.B.P.B.P.B.-.-
-.-.-.B.P.B.P.B.-.-
-.-.B.P.B.P.B.-.-.-
-.B.-.B.G.B.-.-.-.-
B.P.B.-.-.-.-.-.-.-
-.B.-.-.-.-.-.-.-.-
A.-.-.-.-.-.-.-.-.G
