B.P.B.-.-.-.-.-.-.-
-.B.S.G.B.-.-.-.-.-
-.S.W.SB.P.B.-.-.-.-
-.-.S.B.B.-.-.-.-.-
-.-.B.P.B.-.-.-.-.-
-.B.P.B.P.B.-.-.-.-
-.-.B.-.B.-.-.-.-.-
-.-.-.-.-.-.-.-.-.A
-.G.-.-.-.-.-.-.B.G
-.-.-.-.-.-.-.B.P.B
