B.-.-.-.-.G.-.G.-.-
P.B.-.-.-.-.-.-.-.-
B.-.-.-.-.G.-.-.B.-
-.-.-.S.-.-.-.B.P.B
G.-.SB.W.S.-.-.-.B.-
-.B.P.SB.-.-.G.-.-.-
-.B.P.B.B.-.-.-.G.-
-.-.B.B.P.B.-.-.B.-
-.-.-.B.B.-.-.B.P.B
A.-.B.P.B.-.-.-.B.-
